##A##################
#   #################
# # #################
# #   ############# #
# # #   ######### # #
# # # ############# #
# ###  ######## ### #
# ####     ##### # ##
# # #####  ###### # #
# # #####         # #
# ##############  # #
# ##############    #
##################B##
